 #      ##        #  #       
    #### #      # #  #  #    
                   #       ##
#     ##   # # ###  # ##    #
      #    #     #     #   ##
           # #            #  
  # # #        # #       ### 
   ## ####  #      ##    #   
          #         #        
  #            #             
#   # #            ##  #     
#    #  ######   #    #    # 
##     #  ##         # #   # 
             #         #     
        ######    # ###  ##  
 #               #     #   # 
#          ##   ##     ##    
 #  #  ### #  #   # # #      
  ###    #  #  ### #         
              #              
  #       #      #    ##    #
#  #    #       #     #   ###
  #   #          # #  ##     
       ## #   #     ##    #  
     #          #            
   # #      #     #    #   # 
  #                       ## 
        #    #   #     # # # 
#   #  # #       ##    #### #
     #  #             #      
  ##                         
    #   ####        #   #    
# # ##  #    ## ##   #       
 #         #  # ##     #    #
      # # ##   #  ##   # # ##
  # #   #     #     # ## #  #
     #  #   # #              
    ##     # #     #     ##  
#    #          #### #  ## # 
       #  # #       #  #    #
# #           #    ##    #   
   #  #   #      # ##  ##  # 
# ## #   #  #   # #    #  # #
##   #              #        
      #     #                
   #        #   # ##  ##   ##
                             
 #   # ## # #   #     #  #   
#      #  # #    #   #     # 
        #                    
       ##    # #     # #  ## 
##               #    #      
                  #       ###
  ##  #     #     #    ####E#
#     # #  #       ##     #  
              #          #   
  ## #  # # ##   # #  #     #
 ##   #    #   ##  #   #    #
          # #  # # ##  # #   
  # # ##    #      ##    #   
   ##  # ## #   ###    #     
        # ###   ###  #       
#      #   #####  #    #   # 
       #  #    #    #        
  #   ## #       # ##        
 #     #     #  ###  #       
          #          #       
  #       #                  
   # # #     # #    # #  # # 
  #     #   #    #          #
        # ## ##    #  #      
##    ##  #     #            
                             
                             
#   # # # #       #  #  # ## 
#         ##   #     #       
  ## #  #        ##    ##  # 
  #   ##    #          #     
    ###  #   #   #### #  # # 
##  #    #  #  #          ###
                             
 ###  # #        #    ##     