       ##  # ### # ###             # #  #           #    #   #### #  ##         # ### #
  # #  ##  ##  ##  ##       # ##  #   ###  #### #    #     #  # #     ### #   #        
        #    #             #     ##    #  #  #  #        #   #          #    #         
#                     #                                                ##              
                       #                #    #                    #   #    # #         
                  ##                                #   #                              
 ##      #   # ## ##     #### # # # # ### #  # ##      #   #       #   #      #     #  
# #     #  ###  # ##    #     ### #             ##   ##     ##  #    #  # # # ###      
  #   #          # #     #  # #   #  #       #            #  #     # # #   #         # 
 #                       #                    #    # #                              #  
   # #   # # #      # ##          # #      ### ## #      #   ##        # # #  #   #    
 #          #      #     #            #                          #  #     #        #   
               #  #           #       #  #           #   #     #     #  #         #  # 
# ###      ##         #     E   #                 #   #            #      #     ## ##  
                                                #  #   # ##  #     #   #               
####           # ## # #  #   # ##     #  #     #  #    #### #     ### # ####    ###    
             ####       ## ### ####    # # ##  # # #   # ### #    ###  # #    #   ###  
  ## #  ##                 #   #                #            ###  #           #        
      #           #  ##    #    #                  #      ##  #     #   # #    #    #  
     #  #      #     #   #  #        #     #  #  ###  #  ## ## ###    ### ##  # #     #
   # #   #  #   ##            ##   #    #   #          # #   #                         
         #                  ##  #                    #    # #  # #      #  ### #    ## 
  #   #        ##    ##  #     #             #  ###    #  #    ## # #   ##   #    #   #
# ##       ##     #        #  ###      #             #    #  # ####    # # #   ##      
  #                                       #                     # #                    
    #   #      #         ###    #   #     #  #        # ##    #      # ###       #     
#     #           # ##            # #    #        #      ###     # #  # #              
     #  #  #  ##   ###     #        ##       #  #             #       #  ##     ##   # 
          #                         #                                                  
# ###      # # #    #       # # # # #          #       #       #    #  # ### #        #
  #          # ###           ##          #                          #              #   
       #                      #                                     #     #         #  
#                      #   #      #      #                                         ##  
      #  ## #    #      # #      # #       # ##   #        ## ##    # ##      #        
 #              ## #####         ## ### ## ##        #    #   ##  #    #   #  ### # # #
 #  #     #                           # ##  #   #    #   #   #  #     #             ## 
 ###    ###  ##       ##  #   # #   ##       ##       ### #     ##   # #  #### ##     #
  #    #   ##      ##    #  #   ####  ###  ###       ## #   #   #    # #  ##    ## # # 
    #              ##            #           #    #  #        #         # #  ##        
                                 #                                                     
      #   ##         ##                    #          ##       #   ##                  
 #S  ##            #     #  #       ###   # #  #   # #   #         #  ### ##   #    #  
         #                            #            #                 #           #     
#    #     #  ##   # ##  # ###    ## # ## ###    ##  #     # ##      #     #   #  # # #
     ##    ##  # #  # ## #### ###    #    ##    #    # ##   #### # #  #  #   ###  ###  
#  #     #    #    ##      # #   #  #  ## # #  #  # ## ##   #   ## # # # ##  # #    #  
  #  #                #    ##               #      #    #    ## #        #    #     #  
      #           # #    #   #     ##              #                 #                 
   #  # #   ##  ## # #       ## ####  #         ### # #          #  #### #   ##     ## 
###   ##     #              #       #      ##      #   ##      #         #             
  ### # #  #   ## ####    #   #                  ##  ### ## # #    #      # ##  #     #
#       #      ### #  ##    #          ##### ##  # ##   #    #  #   ###   ##  #  ##  # 
                                       #                   # ##            #    #      
#  # #    #   #   ##      #    #      #     #  #     #  #   #              #     # #   
 ## ## ### ##    ##  ##  ##  # #        ##  # ## # #   #    # #  #       #       #   ##
  #          # #  ##  ####  #   #  # # # ###  # # #   # #   #  ## #   # #    #  #      
       #       #                           #                                           
       #           #     #                                                             
              # #       #    #                #     #    #         #  #         #   ## 
     ##    #  ##   ##  # ###  # #  # #      # ## # ## #  ## #     #  #     ##  ##    ##
          #      #              #        #  #               #  #  #        #           
## #         #     ## #   #   ###   ####   ## # ## #    #  #            #  #     # #   
  #     #     #  #    # #  ###    #  #                 # #          ## ##   #    # ####