#    # #  #     #
      #   #      
# # ##     ## #  
    #  ##    #   
    ##          #
 #    #         #
   #   #  #      
   #  #   ##     
#                
     # ##     # #
#   #  # # # #E  
  #   ##         
   #   #  ###    
                 
      # #       #
    #  # ## # # #
                 
 ##   #       ## 
  # #    #   ##  
          #      
     #           
##    ##     ##  
   #      # #   #
                 
#   #  #  ##     
  #              
             #   
## ##   ## #     
  #              
 # #  ###    #   
              #  
#   ##  # # # #  
                 
  #  ## # #      
#                