E #    #  ###    # ## # #    ## ####    #    
#        #     #  #  #     #  #       #      
 #        #   #      #     ##    #    #      
        ####  # ### #   # ##  ##   #         
  #    ##  ##  #    #  #  ###  # #      #  # 
#    #  #     #               #        # ####
#     #          ##       ##  #  # #   ##    
           #    ##                           
                                             
 #####   ##  #  #   #   #   #   # ## ## ##   
  #  #     #    ## ##       # #  #     #   # 
#  # ##              # # #      ##    # #   #
                                             
        #     #      #                    ## 
                                    #   #   #
 ##  #       ## # #     # ## #   #           
#    #    # #     ##    ##           # #     
 S                                           
   #       # #   #   ##  #   #      # ### # #
              ##    ## ### ##      ###  ##  #
  #  #   #  #       #  #  ##    #   ##    ## 
 #   #     ###       #           #     #     
#          #   ##                        #   
     ##      # #  ##    #    ##         #    
                    # #      #    ##         
  # #      #    #  #   #     # #   #  ##  ###
   #                 #                 # #   
  ## ##    #      #  ##  #      #    #     ##
  #   ##  #  #     #       #      ### #  #  #
 ##     #     ##           ## ###     #      
                                             
  ## ## #      # ### #  ##    ##    #### ##  
# #     #         ###   #       #      #     
  # #    #          ####   #  #   ##  #      
                   #  #                      
                     #                       
           #                                 
## #   #  #    #### #   #  #      #  ##      
#   #### #     #     #   #### # #  #  #   #  
      #       #  #   #### #       # #  #   # 
                    #                        
    #       #       #  #   ##           # #  
  #   ### #    ## ##  #  #   #   ####   # # #
   #     # # # # ### ##    # #        ##     
 #   #             #       ##       #        
#  # # ##      #   # #   # ##    #  #### #  #
 ##  #      #    # #   # #    ##  #     # ## 
#  #   #     #   # #  ##  ## #       # #     
 #   ##     #     #                    #     
###                  # ##  #    #     #  #   
   #                       #                 
           #      #  #   #   #  # #          
 ##   ###  #     # #   #      # # #  ##      
           #           #        #   #       E