        #               
                    #   
                        
   # S  #     #    #  ##
     #    #  ##         
                     #  
   #  #        ##      #
      ### ##    #      #
#  ##       #  #  ##  # 
 # ### # #      #   #   
        #  # #  ##      
      #     ####   ##  #
#     #            #    
## #   ## #    #    ##  
        #   # #   #   # 
##   #  ## #   #        
   #    ### #   ## #  ##
    #    ##  #  ## #  # 
 E         #           #
                        
#  #   ### #    #       