#   #          ## ##    #  
 #       ##   #  ##     #  
            #          #  #
  #   # # ## ## #   # S  E#
          #   ##      #  # 
 # ##  # #  #    #    #   #
   ###     #    #          
 ##      ##  #  ##         