##    #             #  ##    ##  #  #   ### ##   
     #    #   #           ## #              #    
    #          #                          #    # 
 ##    #   ## # ##  #      #####  #   ## #   #  #
               # # ##     #     #      #       # 
              #         #  #     #               
    #  # # ##  #    ####  #   #            # ##  
#      #            ##   #               #       
 # #  # #  ###    #         # #  # #        # ## 
  #          #        #               #    #     
  #                                  ## #        
#             ###    # #  ###     #  ### ##  #  #
                       #  #           ##        #
 #  #   #    #  ####  #   #    # #    #     ##  #
  #     #   # #         #    #    #   # #      # 
# #    # ###    #                      # # #     
       #     #### ##  #  # #      #   #        # 
#     ## #  #  #  ## # #      # ##      #   #####
 ## ##  #  #   #  ## ##   #         # #  #  #  # 
                                     #          #
                                                 
  ##   ##    #   #     #     #S###  #  ####### # 
   #   ## ## #     ##  ## #  # #### #         ## 
 #        #   ##### #    #    #  ##    ##     # #
#     #        ## #   ### ##  # # ##  ##   # #  #
                                 #               
     #   #              #    #        # #     ## 
                                      #  #       
  # # #  #    #      #   #     #    #  #  #   #  
    #                 #      #           # #     
       ##       #    # # #        ## #      ## # 
       #  #   #         #       #      #         
     ##             ##    E  #         #    #    
            #      #           # ##          #  #
    #                  #                         
      # #  #        ## #   ## #      # #  #      
  ## #   # # #     ##  # # #          # # #   # #
  #  #  # #                  #   #    #  #### #  
    #       #       # # #  ###        #          
     #     #  #   #         #  ### #   #       # 
   # # ###  #    ##   #  #          #    #       
###  ###  ##         # # #     #       # ##  ##  
                             #              #    
                    #                          # 
  #  #    # #           # #        #       ##    
        #  #  ##    #  # #     #       # #       
                                          #      
    #   ######         ##   ###    #   #     ##  
          #                                      
  #     #    # #  ##  #            ###  #     #  
 # # #   #             # #       #       #   #  #
        #       #   #               #      #     
#   #  #   #      #  #    ###      ##            
 ##  ###  ### ##  #    ##   #    # # # ##      # 
   ##       #       #  # #  #                    
                                                 
#     ###  #  ### #  ##       ### #    #  ### #  
#                 #  #       ##    #    #        
                  #                   #          
      ##   #    #        #         ## #     #    
        #   #   # # ##      #          #     # # 
  ### #  ##   #  ##  # ### #          #   #  # # 
 ###   ##   ##    # #     #  ##    #   # #       
 #### #      # #     #           #      #      ##
 #  #      #         #   #                     # 
     # #  # #    #  #    ### ##        # ##    # 
  ##  ### ##     # # #  #   #   #      #   #   # 
         #     # ##     ##      #       #        
 #     #         ###          #      #   ##     #
   ## ###     #  #   #     #      # #  ## ###  # 
                                                 