#                                       #                #                        # 
#  ##   #    # #  # # #      ## ### # #   #  ##   #        ## ##   # #  ###    #   #
  #             #  #            #       #    #               #          #  ##       
 #  #  #    # #   #  #     # #  ##              #             #  #                  
 # ###      ## #    #   ##      #  ##  #  ##   #  #     #      # #  ##     ##     # 
 #     ##                 #  #           #     ##   #    #          # #   #      #  
       #     ### # #    ##  #  # # # ##    ##        #     #  #    ###   ## # #  ## 
# # #      #  ## # #   ####  # #   #     #              #  # ##         ##     ##   
#               # ####       #    #  #  # #   #  ##    #    # #           #       ##
 # ##     #   #        #              #       #     #                    ##   ## #  
#   ##   #   # ##  #          #  ##        #            #           #    #  # #    #
 #      S  #    #   #  ## #  #       ##    ##     #     ##   # #    #  # #      #   
 #        #   #                #                           #   #                #   
#        # #    # #   ##  ##  #####    #  ##  ##  ###   ## #    ###      # #   ###  
         #                          #                   #           #               
  #  #   ## #          ##    #      ####   #  # ###   #        ##       #     ##    
               #                 #                                                  
# #    # #   #         #     #  #       #       #   # #             #  # #          
          # # ##      ##          #            #     #            # #     #     # # 
 # #  #      ##    ##    #    #  #     #   # # ###  ##      #  ##   ## #  #        #
        #                      #                #                 #              #  
 # #   #   ##   #     #   #               ##    # #      #           #    #  #      
    #  #  #   # # #           # ##  ##     ### # #   #   #  ##          #          #
 #                       #     ####         ##    #    ##         ## #  ##          
      #            ### #              #            # ####         #            # ## 
         #         #  #    #  # #                     #    #          # #    ##  ## 
# ##### #  # #  #   #  #  #     #     #     #  # #        #       #     # ## #  # # 
 #       #  ##  #  #    #  # ## ###    #  ## #             ##   #  ##   #  #  # ##  
      ###  #    #   #  #      ##       ##  # # #       #        ##   # #   #   ## # 
    #      ###  #  #         #  # #    #  #  ##        # #  #   #    #           #  
## # # ### # # #        ##       #   # #    #       #  ###  #   #   ##      # #    #
##  ###  ##  #   ##   # #          #   ### #  #   # ##    #     #    #              
 # ###            ####   # #  #    #  #    ##       #          #   #   ##           
    ##  ##     #  # #    #   ##      # #   ##   ##    ##    #   ###   # #  #    # # 
  ## #                 # #      # #       # #      #            #          ## ##    
   #  #   #   ## ## # #   #   #         #   #  #### # ##     ##         # ##    ##  
    #  #      #       #   # #    #      #      # #  #        #          # #         
#  ##  # #   ## #   # # # #    # #  ##   #   #   ## #     ## #    # ##      #  # #  
     #        #               # #                                                   
                              #                       #             #               
   #  #                #   #    #    ###  #               #   # ##       ##   ##    
      #     #  ## ##     #   ## #  ##    #      ##   #####     # ## #   # ## #     #
 #           #      #   #    #    ##    # ## #           #  #         #         # # 
                  #            #     #                ##             #     #  # #   
#          #   #    # #  # #   ##     ##        #   ##      #  #    # #     ##      
      #                  # #    #        # #     #        #       #                 
                      #     #         #                                             
   # #   #  # #  #  #   ##    #   # ##      # ## ###       # ##  #       #   ## # # 
                                                                                    
 #     # ##    #        #                    #        #  #  #      #                
      #          ## ##      #   ###  ##           #          # #    #      #   #  # 
##     ###     ##  #  #           #  #  #  ##   #  #    #   ##   ##         #    #  
                     #                 #               #             #              
      #  #  # #### # # # #    #     ##   # #       #       ####      #   #        # 
     #          #   ##  #    #  #              ####         ###         # ## #  #  #
   # ##         ###   #      #  #   #     ##     ##   ##     #   ##  #    # # ###  #
 # #  #  # ###    #   ## #       #      #       #  # #      #   #    #      ##   #  
  ##     ##     # #   ##          #         ##  #####  # #  ##  #   #    #    #    #
     #    ##     #   #                                               #           #  
  #   #      # # # #  #              ####  #   # #       # ## ## # #    # # #       
#    #      ## #         #        #          #   #  #   #    #    #    ## #         
              #    #   #               #        #     #                   #       # 
 #  #          #           #    # # #     #   # ####  #       # #       #       #   
    ##   #       #   ##   # ##        #   # ##           #  #     ##    #  #  ##    
     #      #              #        #  #                ##        #             #   
  ## # #   #   # #   ## #  # #   #  ##   # #    ###   #  ### E# #### ###  ###       
##                        # ##      ##                  # ##            #      ## # 
  #  #      #                    #       #              #        #    #   ###    #  
 #    #  # # #  #   ##           #          #    #     #    ###     #   #     # #   
 #         #          #  #            #  ##     #                   #  # ##         
   #  #   ##    #      #      #   #    #      #  #         #  #       # ##   #     #
#  ###  #    ### ## #      ## #     ##              #            ###  # ##     #  ##
  # #  #     #    #    # #      # # ## #    ## #   #     #    # ##  ##   # #     ## 
     ##         #                                              #                    
    # #   ##  #  ##    #     #  #     # ##  ##      ##   #    #   #  #  ##    #     
     #   # # #    # #   ##  ### # #  #     #  #    ##### # # #  ###    #   #  #  # #
                                                      #                             
                             #       #                   #               #          
                                                                                    
# #  # #      ###  #    #   ## #     #   #   ###      ### #      #  ##  #  #   #  # 
         ###       #  #     #     #      ##    #     ## ##   #   #   #  ##    ##    
 #     # ##   # #  # ## #### # #### ## # ### ## #  # #    #              # #      # 
     #   # ##         #            #         #       ##   #        #  #    # # ##   
  ##  ##           # # ##    ##  #  #  #    # # ##       #   ##    # #       #  # # 
                                                                        #           
#       # # #        #     #   #   #   #          #    #      # #    # ## ##  #  ###
        #### #     #      #   #   # # #  #            #          ###   #          # 
 #    # #           ### # #       # #  #              ##  ## ##    #   ## ##       #
 ##   #     #    # #     ##   # #    ## ###    # # # #  # # #  #### #   #   ## #   #
                #                #    #              #                    ##        
 #       #             #                 #  #           #          #                
 #    # #      #  #  #   ### # # #  #    #    ##    #  ####  #   #        ##### # # 
## # #  ##  #   #    ##     #          # # ##  ## #       #    #  ##     ## #   #   
                 #                   #    #                                         
#  #     # #  #             # #    #                 #  #   #     #           #     
          #                                   #      #            #     #           
 #  # #    ###       ## #  #   #  # #     ###    ##### # ###   #  ###  #     ###    
            #                                                                       
  #  #          #    #   #  #     #                            #  ##    # # #    #  
        #  #   ##     #        #               ##        #  #               # ##    