         #   #
    # #       
#    # #  #  #
           ## 
      #       
           #  
#   #  #     #
 ##    # # ## 
    #         
          #   
#             
              
 ##   #       
              
 #  #  # # #  
              
 # # #       #
   ### ##    #
     #        
  #           
       #     #
 #           #
#  #    # ##  
              
 ####    #   #
 # #   #  # ##
S  #  #    ## 
    E         
#      #   ###
        #     
   # ##      #
 #  ## ##  #  
              
          #   
###       #   
  #   #  ##  #
              
   #          
   #    #     
   #     # ###
##   ##    ###
              
     #        
#     ##   # #
  ##   ## ##  
# #  #    #   
   #      #   
              
  ###       # 
##  #   ##    
###  ###      
#             
  #     #   # 
              
              
        #     
 # # # #  #  #
#   ##   ##   
 ##           
 #   #       #
   #     #    
    #  #     #
#  ##      #  
        #   # 
    ##        
          ##  
              
 #  #         
## # #   #    
#    ###     #
###      ##  #
 #    # #   # 
 #    # #    #
 #      ##   #
              
#   ##        