#     #   ## #        ##    ###        ##   #  # ## # #   ## #   ###    #   # # ###   # 
#           #            ### #                        #     #     #       #        ##   
   #                                #            #  #   #   #                           
         #                                                                              
    #        #              #    ###      ##         #                  #               
  # ##  #   # # # #   #### ## #     #     ###   #        #     ###      ##  # ##  #  #  
           # #       #    #     #  #                #                    #   ##  #      
 #  #    #            #  ##  ##  ##  # #  # ##       ### ##   # #  ###E   ##    ##  ##  
                                                                                    #   
#            ## #      #       ## #   #      ##      # # #    #              #      ##  
###   #         ####    #  #   #        #  # #      #  # # ##  # #   # #         #      
#     ###   ###   ##  ##   #  # #  #   #    ##   #        # #  #  ## ## #     #   ##  ##
 #             #      #           # ##      #      #                         #          
   #   #   #   # #    #   #  #     # ### #   ####           #      ##     # ###    #    
       #  # #  #   #    #  ## #   #           ### ##  ###    #    #   ## #  ##    #   ##
#                ###     #   #               #      ## #         #         #   #        
   #         ###         ##  ###  #         #  #          #      #      #            ## 
      # # #       #   # #   #       ##   # ##     ## ### # #  ##     #         # #     #
  #      #  #    #     ##  # ##    #    #  #       #   #### # #          ##    # ##   # 
  ##        ##  ## ###    #   # #  # ##       ##  #  #   # #       #   # #    #         
   #  #  # #           #   #  #           #   #     #           #  #   # # ##   # #     
        #   #       # #  ###      # #   #   #### #  #     #     #       # #      ## #  #
    ###  #     # ## #   #  #      ###  ##  # ## #    ##  #       # ##         #   #     
 ### ## ## #   # ##  #   #  ## ## #     #         #    ##     # # #  ##  ## ##          
#          # # #      # # ##  # # ##   # #  #   #   ## #     ### # #    # # #     # #   
     # #       #     ##   ###   # ##  #### # # #  #   # #  # #        #     ##       #  
   ##### ##      #     #   # ##### #  ####    #   ####  ##  ###     # #### #       ##   
#   ##    #            #                      ## #   #   ##   #   #   # # ##        # ##
            #   # #         #   #     #     #                  #        #   #  # #      
      ###  #    # ##  # ##  ##    #    ## ## ##  #      #####    ##   #  # # #    ###   
                   #                 #                                        # ##      
#              #   #       ###  #        #         #      #   #  #          #           
  #    #               ##             #                               #            #    
                 S       #    #                     #         #              #          
 #  #  #  #  ##         #    # ### ## # ###   ##          #  # #         #  #  ###   #  
       #  # #     #  #  #  ##     ##          # ##  #                 #             # # 
     ## ##   ## ## #   #  ### # ## ##   #        # #      # # #      ###  #  #  ##    ##
  # #       #        ##    ###             #                         #    #    # # #    
#   # # ####   #### #   #    # #           #      # #  ##  #             # ## # # # ##  
  # ###    ####     #  #      #   ###   ##   ##   ## #      # # #  # # ##        #   ## 
                                                #                                       
                                                                       #               #
     # ### ##   # # ##  #      ## ##     # ##   # ##         # #       ##    # ###   ## 
   ##                                                 #      #       #  #       #  #  ##
       #  #                 # #    #            #             #   ##               ##   
   #  #  #  ##  #  #  ##   #   #   #  #       #  # # #    #   # #  #      ## #  #  ##   
 #      #   #       #  #    ##  ##   ###  #          #  #       #    # #    ##          
   #    ### ##    #    #     ##    #   # #  # #  #             ##          #          # 
   #  #   #    #  ####      ## #  # #       ##  ###  # #  #    # #    # ###             
            #          #          #           #         #                         #     
    # #  #                                    #                         #         #  #  
        #   #    #     # #               ##    # #       # #  ####   #     #           #
         #         #                        #   #      #                  # #   #       
             #                                           #                              
             ##  #  #       #   #   #       #   #         #  #      #  #        # ##    
  #       ##   # #     #  #       #  #     #            #  #  #      # #     # #  # #   
  #  ####  ##    # #         #             #      # # # ##            ##         #   ## 
 # ###    ##    # #  ##   #                   # #  #   ###  # ###  # # # #       # ##   
     #  #     ## ###            ##  ###### #    ## ##    ### #    ## #  ##   ### #   # #
       # #        # # #   # ## # #        #  #  ## #   # #    ## ##  ### ##  # ##   ####
        #    # # #    #    ###   ##      # #     ## ##    ##    #  #           ##   #   
                                                #   #                   #               
# # #     ## # #      # # ##     #  # ##   ###   # #        #    #     ##       #   #   
         # #   #   ## #  ##     ##  #      #   # # #  #  #### ###    #  #  #  ## # ###  