   # # #           ##      #   #     #        
#  #  #####  #     #                #  # # #  
##     ##   # # ###  #   #        #   ## ##   
           # #         #  ##     # #          
             #         #    #           #     
                                              
  # #   #      ## #  ##  #     #  ##  #  ##  #
        #  #          #     #                 
    ####  # ##  #  ##  #   #    #       ###   
##  # # #   #     # # #    # # #  ##     #    
   #  #        #### ##  #  ## # # #  ##  ###  
                          ##    #            #
        ##  #      #  ####            ##      
       #  ##       ## #    # ##            # #
  # #  # #   ##   #     #  # # ## ###  #  ## #
# # # #   #        #    #  # # #    # ##  # # 
     # #                #      #           ## 
                                              
 #          #  #       #        #    #  #  ###
        #  #  ## #  #    ##     #    # #  #  #
#      ###    #  # # ##   #   #     # #  #   #
     #                                        
 ## ####  ## ###  #            ###   ##  #    
    ##  #  # #  # ## #   #               ###  
                          #      #            
  #         #    #      #         # #         
       #    #         #  #####  #    # ##  #  
 #            #     #                     #   
  # ## #  # # ## #  #  ##      ##  ##     ## #
#   #       #    #      #     #  #  #    # #  
   #      #  ##   ##  ## # ##  #  #  #  ##    
                                        #     
            #                #     #     #    
       ##      # #       #                    
  #        #                       #         #
  #      #   #           ##              ##   
 #  #  ##          #  #   #   #               
   #  #        #   #        #               # 
# #  #  #        #    ##   #  # #   #    ## # 
   ##    #   #               #  #          #  
#         ###    #### #       #     # ######  
           #   #  # #   #  #    # #    #      
     #    #  # #   #           #     #  #   ##
           #                 #                
  #  # ##     #    #    #    #  ###      #  # 
  #     #      #      # # #      # #   #      
      #       # #                    #       #
 #        ##    #      # # #  #    #      ##  
  ##   #   #   #   #    #    #  # #  ## # # # 
#    #   #    ### ##  ###  ##           ##  # 
         # # #  ######   ##   ###        #  # 
  # #     ##      ##      #  #   ##     #     
                                         #    
      S#           #           #              
 ###  #            #   # ##         # #   #  #
  #   ## #  ##     # ##  #     #   ##  # #  # 
   #   #   #  # # ##  # #   ###     ##    # # 
 #           ## #     #        # #            
  #  #   #  # ## ## ##   #     ###  #   #  # #
             ##     #   #         #          #
                                            # 
   ##    #          ## #      #   ## ### #    
 ####      # ### ## ### # # # #  ##    ##     
   #   #         #      ##      #           # 
#####  ####          #####  ##  ##   #  ##   #