S   #          # ###     #  ###      #   #   #  #     
 ##  #  #   #      # ##   # ###     ### # # # ####    
 #     # ##  #### #### #       #  # #   ##  #        #
 #  # #       #      #     #   #  #                 # 
 #       #   ### #  #  ##   ##      # #  # #     # ## 
  ## ### # ##  # #### #   ##E# # ##      # #   #  #   
           #                            #  #  # #     
# #  #   #   #    #  # #     ## #          #       ##S