                                                    
         #   ##               #             #  #    
#      ##      ## ##### # #   # # #  #    # #    #  
#         ###    #         ###     #    #    # # #  
#  #     ##   #  # #    # ## # # ##      ##   ##   #
#   ### # #  ## #      # # ## ## # # #  # #    #    
 ##       #    ##       #  #  #        ## #   # # # 
#      ##    #   # ###       #   #    #     ##     #
       # #    ###                  #   #   ###  #   
  ## #     # #    #  #    ##  #    # ##  # #        
            # ##   # #       # #          # #     # 
#      #   # # #   #    ##   #  ## ### #      #  ###
 ###  ##        #  #        # #  # #                
       # #                #                    #    
## #     #    ##    #  #  #    ### ###  # ###   #   
     #  #   # #   #  #       ##     #         # #   
#    ##  ### ## # #  #    # E  ##   ##        #   # 
                 #          #  #      ##      ##   #
  # ###   ##       ## ##  ####  #   # ##   #    ## #
    #  # # ##     ###   #  #  #  # #    ######      
  #   #            #  #    #           #            
     #  #    # # ##      ##   # ##  #     #    #    
#   #   #  #     #  # ##  # ##         ###    # #   
     #    #   #         #               #           
      # #   ##             #     ##            # # #
 #      #   ##          #       #     #      ##    #
 #   # #    #       #     #    #            #   # ##
    # #    #  # #   # # ####              ####    # 
  #   #  #      # # #  #    #      #      # # #     
##   ##   #   #  #  ##   #     # ###           ##S# 
  # #                                       ##      
      ### #  #####                     #  #    #   #
             # ##  #       # #   ## #   ##   ###  # 
                                                    
        # ##               #            # #         
    #        #                 # ##                 
   #  ###        #    #          #    #      #      
#    ##### ##   # ##       ####   #    #      # #   