   #  ##  #   ## ##  ####         #     # #     #           ##   # 
  #     ###   S#   #       # #     #    ####    #    #  # #        
                    #   #        #   #     ##          #  ##    #  
         #      #  #                                 #      #      
## #  #  ##    #   #      #  #####  #    #   #      ##  ##  #  ####
       #                       #                            #      
  # #               # ###    ##    ## ## #     ##   # # #      ##  
  ## #   #  ##        #   # #  #    #         #       #       #  # 
     #        #   # ###   ##    # #       #  ###   #   #  ####     
    #          ##  #  ## #  # #  #    #   ###       #      #       
# #    #   #       # #   ### ##  #    #  # ##  #  ##   ## # # ###  
  # #  #    ## #  ##      ##   #     ## #     #    ###   ##      # 
   # #   ##  #   ## ####      #   # # #    ##     ##   #    #  ####
    #  ## ##   #   ####   ##   # ##      #     # ## ##           # 
    #  ##  #    #     #  #             #                       # # 
# # ##     # # #   #   #                #   # # # #   #   #     ###
 #     ##     #    # ##   #  #  ## ##   ###   # #                  
      #                                   # ##        #          # 
##   ## #       ## ### #  #          ###      ### ##    #       ## 
 # ##          # #         #  #  # ###  #   ## # #  ### ##  # # ## 
 ##  # #  ##   # #   #   ## #  # #     # #    #          #    #####
 #   # #  ### #   ##  #  # #     ### #  #   ## ## #   ##   #  #   #
#  #  ##     #          ##  #### #     ##   ##   # #            ## 
    #           ## #   ## #       #  #  #     # #   #   #    #  #  
   ###     ## # #    ##              E # #         #  #       #  # 