 #            #  #    ##  # S# #    # ## # ##      ### # ##     ####  #        #   
##  # #   ## #       ##    #     #          ##  #  #   ##    #   ##  # #  #    #   
#    # #       # #     #     #    ##      #    #     #                         #   
        #                                               #              #           
#    #   #     E# #  #  # #        # #  #    #     #   #       # # #  #  #   ##    
#     ###     ##  ##     ###    # #  # # ###      ## # # #  ###      ##  #  ### #  
#   #      #       ##  # # #   ##  # # ##   ###     #          #     #    #       #
                                                                                   
    # #  #  ##   #   # # #     #       ##   # #   #            #  ##   # #  # # #  
#        #   #    # #   #  ##  #                                   ##       #      
 #                                                          #                #     
     ##  ## # #  # # # ###  #   #    #  ##       #     #   #    #   # ###   ## #   
#     # #       #      ##     #   #  #   ##   #  ## #    # # #     #        ##    #
  #     #         ##     #     #  ##        #    #  # #        #  #  #    ####     
             # #   #    #          # #    #                       # #              
 #   #  #    #   # ##           # # #          #             #      ##    #    #   
##     #     # ##  ###     #      ###   ##### #       #  # #  #        ##  #  #    
                            # #                        #    #                 #    
     #  #    #  #   # #     # #   #          #        ## #         #            ## 
 #          #     #   #   #     #     #####       ## #  #   #    # #         ##    
      ##  #    # #   #   # ## ## # #      ###     # #   # #   # #  # ###  #   #    
 # ##           ## #   # #    # #   # # #    #  #       #   #             ### #    
        #                     #                                                #   
#       #  #                   #  ###   #           #  ##   #                 #    
      #                                                          #                 
## ### #   #  # #              #  #      #  # #   #   # #  ##     ###  ##  ##   # #
#    #  ######    #  ###      ## #     #     ####      # #           #    #    #   
  # #  ##      #         # # ####     ## ###   ## #   # #  # # #   #  # #### #     
##       # #    #  # ### # ##  #    ###    ####     #    #### ##     #  ####    ## 
 #  ## ### ##         #   #    #    ##  ####  #   #  ##  #   ##   ## # #    #    # 
#  ##       #  # # ##    #       ##   # #  #   #     ##     #  #         ## #####  
#            #   #   #         ##        #                             #       #  #
      #   #                      #        ##      #    ##             #            
  #          #                                                                     
 #       ##  ##        # ##   #       #     #  #     #            #       #        
#  #  #  # #  ## #    #   # #       #           ## #         ## #               # #
# #                #   ## ###    ##       #  #         #           #  #   #      # 
                                                             #                     
 #      ##                 # #   # #     ##  # #   ##        # # #            #    
 #      #  #   ##  # ##  # # ## #### ##        ##      # #  #  # # # # ###      #  
               #  # # #    ##             # ##   # ## #  ##   ##   #         ##    
 # #    #  #            #      ##     ##      #### #           #   #       #     ##
 ###  #     #   # # # #   #     ####      #          #  ##  #    ## #     # # ##   
 #                  #                                                              
      ##     # # ##         #     #  # # #       # #           #           #  #    
     #                  #                  # # #             #         #      ##   
                                                                                   
   ##         #            #            #  #         #                   #      #  
                                             #        #                            
    ##           #   # ####          #       # #   #      #    # #  #     # ##     
 #  # #    #      ####   #         #      #                #   #    #     #        
##    # #      #        #    #    ####  #       ###   #           #   #      #     
# # # ###     ## ###  #       # #  # #     #     # ##    # ## # # #  #       #   # 
      #  # # #      ##   #  #  ## ##  #  #   #    #  ##  #   # ####   ##      # #  
  # #                 ##       #            #   #        #                   #     
 ####    ##    ##      #  ## #  # #  #  # ##      # # #   #     ## #  # ## ##    # 
 ##  #                           #            ## #   #  #     #   #    #     # ##  
#   ###      ##       # # ##  ###    #       # # # ##   #  ##  ##           # ##  #
    #           # ### # #  # # #   #         #              #     ##   #     #    #
                  # #                                                              
 # #  #     ## #   # # # # #        #           #       #          # ##  ###       
    #  #   ### ## #    #  ##  # ##  #         #  #      #   # #   #   # ##     #  #
 ##  #        ###     # ## #    #    #      # ##   # #   ## ###  #       # #   ##  
  #    #                 #  # #                           #   #  #              #  
    #     #    #             #   #  ##  # #     #   ##     #     ###    # #  #     
 ## ##        ## #   ##          #                # ##    ###   #    ##  # #### # #
   #     #           #  # #       #                # ## #     ###  #          #   #
# #           #  #    ##   ###       # #   #   ### # # ##      ##  #    ##  #   #  
 #    ##        ###   #     #            #     # #         ##  #   #     #         
 #    #  #         #     ##  #   ##           ## ##  #      #  ######  ##  # #  #  
                     #      # #       ##     #            #                        
                                                                       #           
    #        ###   ## ## # ##  #      #  # #    ###### ## ##  ##       # #     # # 
     #     ####            ##   # #   #     #     #    # #         #   #     ## # #
 #               #     #                   #  #                                    
                 ##   #        #            #                    #        #      # 
#  ####   #   ###   #  # ## ## #  #     #   ##   # # # ##   #  #  #        ## #  # 
 # #          # #     ##   #   #   #     #       #  #  #       ##   #   #   ## ##  