         #   #
    # #       
     # #  #  #
           ## 
      #       
           #  
    #  #     #
 ##    # # ## 
    #         
          #   
              
              
 ##   #       
              
 #  #  # # #  
              
 # # #       #
   ### ##    #
     #        
  #           
       #     #
 #           #
   #    # ##  
              
 ####    #   #
 # #   #  # ##
S  #  #    ## 
    E         
       #   ###
        #     
   # ##      #
 #  ## ##  #  
              
          #   
 ##       #   
  #   #  ##  #
              
   #          
   #    #     
   #     # ###
 #   ##    ###
              
     #        
      ##   # #
  ##   ## ##  
  #  #    #   
   #      #   
              
  ###       # 
 #  #   ##    
 ##  ###      
              
  #     #   # 
              
              
        #     
 # # # #  #  #
    ##   ##   
 ##           
 #   #       #
   #     #    
    #  #     #
   ##      #  
        #   # 
    ##        
          ##  
              
 #  #         
 # # #   #    
     ###     #
 ##      ##  #
 #    # #   # 
 #    # #    #
 #      ##   #
              
    ##        