#####  ########
#S            #
#  #########  #
#  #       #  #
#  #  ###  #  #
#  #  #E#  #  #
#  #### ###  ##
#            ##
###############