#    #  #  # #  #     #             # #   #   ##  #
#    #     ##   #  #  ##  # #  # #      # #   #  ##
##        #         # ###      ###           #     
        ##                                #   #    
                         # #       #    #          
  ##   #  # # #     #     # # #      ## #   ###   #
                                                   
         # #### ##                   #       #   # 
        ###    #            #      #          #    
 # ##      # #  # #  #   #           #    ##   # ##
   #   #   #     #                 # #       #     
#    ##   ## ###       #     ##  #     #    #    # 
          #    #                           #     # 
 ##  #  # #      #   #       #     ## #   #    ####
  #   #    ##  ## #       ### #       # #          
 # ##    # #          ###  #     #   # # #         
      #       #    #  # #    #                #    
    # #  # #  #          ##    ##    #        #   #
##   #   #    #     #  # #    # ##  #        #     
  #         #         #           #   #   #   #    
    # #    #  #    #   #   #  #   #  #      ####  #
   #    ##              #   ##   #  #       #  #   
  #       # #    ## #        #  #    #   #   #   # 
   #          #        #    #   #  #   ##   #    # 
       # ### #   # # ##  #       ##    # #  # #    
        #      #    #   ##    #   # ##    # #      
#  ##    #                  #    #    #  #         
    #  # ##       ####     #  ## ##       #   #   #
 #    ####      #### ##     ##          #  # #     
# #   #         #     # # ## #             #   #   
 #    # ##  ### #         #      #    #  # #     # 
                          #                        
##  ##  #    #      # # ###          #    #     # #
   ##     #  #  ###   #  #   #    ##       #       
 ##  ## # #   ##   #   #    # #   # #   #     #  # 
  # ##  #   # ##  #      #         #  #   #     ## 
                     #                    #     #  
         #               #  #  #            #     #
   # ###    ##   ##  #      ##            ### ### #
   #  #  ### ##  #   #   ###  # # #        #  #  ##
#  #####    ##    #         #       #      #  ###  
              #                                    
         #  #                         # ###  # #   
             #   #         # #                #    
 # ##              #       #      #  ### ##    # # 
               #   # ###    #       #   ## # #   # 
                                                   
# #         # ##   ## #    ##  ###         #       
##     # #       ##   # #       ##      #  # #     
#####     ##  ##  ## ## #      #        # #   #    
 # #  ###    #  # #   ## #  ##   ##              # 
        ##     #       #                       #   
                                             #     
#     ## #     #                  #   # ###        
 ## ##   #    # # #       #    ### ##   ##   #     
    # #    ##      #    #     #            #       
    # #  ##   ##  #       ## #   #     # ##    ##  
    #        # #  #         # #    #          #    
     #    # # # #      #        ##  #         # #  
         #  #          ##         #     ##  #      
  #             #   #     #       #        #       
 #      ##  #                      #    #       # #
   #         #           #  #     ##          ##   
            #                  ##  #   ###   ## ## 
                           #                       
 # # ##  #  #                # #   # #    ## # ##  
  ###        #   #  #     ##  #             ####   
### #        #   ##  # #  #### #   #       #  # #  
#    # #  #  ## ## ###        ## ## ##     ## ###  
 #   # ### ##  #    ##   #    ###  #  ##  #      ##
#    #  # # # # #    ## # #  # ###   #  #   ##    #
     #                  #   #  #         #      # #
              #                          #   #     
          E                                  #     
  #   #   ##  #  #   # #           ##     #        
#  # #   ##  #  ##   #    #    # #     ## #       #
    ##      ##              # #    #  #   #        
  # ##  # ## #   #  #  #        #      #       #  #
   #       #   ##  #       #      ##  #        #   
                                                   
#     #      # # # #  # ## # #      #  ###  #  # # 
  #      #  #                   #       #   #     #
  #       # #   #  #   #  #   ##  ## ##         #  
    ## #      ####  ##  # #    #   # # ##  #    #  
   # #   ##  #            ##   ##         #  ##    
  #       # #  #                       #           
     ###       #                        #          
          #            #      #                    
#   #    # ## # # #   # #            #   #  # ## # 
                 S                                 
#         #    #  #     #          #           ## #
  #                      #         #       #       
      #  #       #                    #         #  